AAAAAAAAAAAAAAADAAAAAAAAAAAAAA
A                            A
A                            A
A                            A
A                            A
A                            A
A                            A
A                            A
A                            A
A                            A
A                            A
A                            A
A                            A
A                            A
A                            A
A                            A
A                            A
A                            A
A                            A
A                            A
A                            A
A                            A
A                            A
A                            A
A                            A
A                            A
A                            A
A                            A
A                            A
AAAAAAAAAAAAAAAAAAAAAAAAAAAAAA