AAAAAAAAAADAAAAAAAAAA
A                   A
A A AAAAAAAAAAA     A
A A           A     A
A A AAAAAAAAA A     A
A AA          A     A
A A  AAAAAAAAAAPPPPPA
A AA          APPCPPA
A A AAAAAAAA  APPPPPA
A A         A  AAAAAA
A AAAAAAAAA AA      A
A     H   A ACAAAAA A
AAAAAAAAA A ABBBA A A
A       A A A   A A A
A       A A A   A A A
A  AAA  A A A A   A A
A  ACA  A A A A A A A
A  ADA  A A A A A A A
A       A A A A A A A
A                   A
AAAAAAAAAAAAAAAAAAAAA
