AAAAAAAAAADAAAAAAAAAA
ABB              HBBA
AB      P B P    HCBA
A       H B H    HHHA
A       H B H       A
A       H B H       A
A      HH P HH      A
A     HH  B  HH     A
A PHHHH   B   HHHHP A
A         B         A
A BBBBPBBBBBBBPBBBB A
A         B         A
A PHHHH   B   HHHHP A
A     HH  B  HH     A
A      HH P HH      A
A       H B H       A
A       H B H       A
A       H B H       A
AB      P B P      BA
ABB               BBA
AAAAAAAAAAAAAAAAAAAAA
