AAAAAAAAAADAAAAAAAAA
A                  A
A    BBBBBBBBBB    A
A                  A
A                  A
A                  A
A                  A
A                  A
A                  A
A                  A
A                  A
A                  A
A                  A
A                  A
A                  A
A                  A
A                  A
A                  A
A                  A
AAAAAAAAAAAAAAAAAAAA
