AAAAAAAAAADAAAAAAAAAA
ABB               BBA
AB  HHHHP B PHHHH  BA
A  HH     B     HH  A
A HH      B      HH A
A H       B       H A
A H       P       H A
A H       B       H A
A P       B       P A
A        HHH        A
A BBBBPBBHCHBBPBBBB A
A        HHH        A
A P       B       P A
A H       B       H A
A H       P       H A
A H       B       H A
A HH      B      HH A
A  HH     B     HH  A
AB  HHHHP B PHHHH  BA
ABB               BBA
AAAAAAAAAAAAAAAAAAAAA
