AAAAAAADAAAAAAA
A             A
A HHHH   HHHH A
A HC P   PBBH A
A H  P   PBBH A
A HPPP   PPPH A
A             A
A             A
A             A
A HPPP   PPPH A
A HBBP   P  H A
A HBBP   P CH A
A HHHH   HHHH A
A             A
AAAAAAAAAAAAAAA
