AAAAAAAAAAAAAAAAAAAAAAAAAAAAAA
A                            A
A BBBB  BB   BBBBB   BB BBBB A
A B                        B A
A B                        B A
A B                        B A
A    BBB  BBBB  BBBB  BBB    A
A    B                  B    A
A B  B                  B  B A
A B       BBBBBBBBBB       B A
A       B            B       A
A       B            B       A
A    B  B            B  B    A
A B  B  B            B  B  B A
A B  B  B            B  B  B A
A B     B            B     B A
A B  B  B            B  B  B A
A    B  B            B  B    A
A    B  B            B  B    A
A       B            B       A
A B       BBBBBBBBBB       B A
A B  B                  B  B A
A    B                  B    A
A    BBB  BBBB  BBBB  BBB    A
A B                        B A
A B                        B A
A B                        B A
A BBBB  BB   BBBB   BB  BBBB A
A                            A
AAAAAAAAAAAAAAAAAAAAAAAAAAAAAA