AAAAAAAAAAAAAAADAAAAAAAAAAAAAA
A                            A
A BB                      BB A
A BBB    HHHHHHHHHHHH    BBB A
A  BBB                  BBB  A
A   BB                  BB   A
A      B              B      A
A     BBB            BBB     A
A      BBB          BBB      A
A       BBB PP  PP BBB       A
A        BBB      BBB        A
A   H     BBB    BBB     H   A
A   H      BB    BB      H   A
A   H       B BB B       H   A
A   H       P    P       H   A
A   H                    H   A
A   H       P BB P       H   A
A   H      BB    BB      H   A
A   H     BBB    BBB     H   A
A        BBB      BBB        A
A       BBB PP  PP BBB       A
A      BBB          BBB      A
A     BBB            BBB     A
A      B              B      A
A   BB                  BB   A
A  BBB                  BBB  A
A BBB    HHHHHHHHHHHH    BBB A
A BB                      BB A
A                            A
AAAAAAAAAAAAAAAAAAAAAAAAAAAAAA