AAAAAAAAAAAAAAAAAAAAAAAAAAAAAA
A    B                       A
A  B B                       A
ABBBHB                       A
A                            A
A                            A
A                            A
A                            A
A                            A
A                            A
A                            A
A                            A
A                            A
A                            A
A                            A
A                            A
A                            A
A                            A
A                            A
A                            A
A                            A
A                            A
A                            A
A                            A
A                            A
A                            A
A                            A
A                            A
A                            A
AAAAAAAAAAAAAAAAAAAAAAAAAAAAAA
