AAAAAAAAAADAAAAAAAAA
ACB    B   B       A
A B BBBB BBBBBB BHHA
A B  BHB      B BBHA
A B BBHB  B B    BCA
APB B HBBBB B BBBBBA
A     BB B  B  BHH A
ABBB BB  B BB  BBB A
A  B B  BB P   B B A
A BB BB BHHB B   B A
AP      BHBB BB BB A
A BB BB BBB   B    A
A B  B  BCB BBBBBB A
A B BB BB B B   B  A
A B B  B    B B P  A
ABB BB P HB B BBBB A
AH   B BBHB   B BH A
AHH  B  BBBBBBB BB A
AHH                A
AAAAAAAAAAAAAAAAAAAA
